5 5
s . * . .
. . . . .
. . . . *
. * . . .
. . . . t